00000000000000000000000000000000000000
00000000000000000000000000000000000000
04223000000000000000000000000000000000
00000000000000000000000000000000000000
00000000000000000423000000000000000000
00010000000000010000000000000000000000
00000004230001000000010100000000000000
10422300000100000000000000000000000000
00000000000000000000010100000000000000
00000000000000000000000000000000000000
00000000000000000000010100000000000000
10043000000000000000000000000000000000
00000010000000000000000000000000000000
01000043042222222230042300000000000000
00000100000000000000000000000000000000
00010000100000000004300000000000000000
00000000000000000000000000000000000000
00000000000000000000000000000000000000
00000000000000000000000000000000000000
00000422222230000000000000000000000000
00000000000000422222300000000000000000
00000000000000000000000000000000000000
