00000000000000000000000000000000000000000000000000000000000000000000000000000000000000000000000000000000000000000000000000000000000000000000000000000000
00000000000000000000000000000043000000000000000000000000000000000000000000000000000000000000000000000000000000000000000000000000000000000000000000000000
00000423000000000000000000001000000000000000000000000000000000004230000000000000000000000000000000000000000000000000000000000000000000000000000000000000
0000000000000000000000000010000000010100000000000000000000042230000000042300000000000000000001010100000000000000000000000000000000000000000000000000000
00000100004223000000000010000000000000000000001000000001000000000000000000000423000000004223000000000000042222222222222222222222222222222222230000000000
00000000000000004222230000000000000101000000000000422300004230000000000000000000004223000000000101000000000000000000000000000000000000000000000000000000
00000000000000000000004222222230000000000000000000000000000004223000000000000000000000000000000000000422300000000000000000000000000000000000000000000000
00000000000000000000000000000000000423000422304230000000000000000422222222222300000000000000422230000000000000000000000000000000000000000000000000000
