00000000000000000000000000
00000000000000000000000000
00000000000000000000000000
00422222223000100000000000
00000000000000000100000000
00000000000000000000100000
00000000000000000000000000
00004222300042222222222300
00000000000000000000000000
00000000000000010000000000
00422230000000000100000000
00000000000000000000000000
00000000042222300000000000
00000000000000000000000000
