0000000000000000000000000000000000000
0000000000000000000100001000000000000
0000000000000000100000000000000000000
0422222230000100000000042300000000000
0000000000000000000000000000000000000
0000000000000000000042223004222230010
0000000000000000000000000000000000000
0000000000000042230004300043000101000
0000000000000000000000000000000000000
0000000000010000000000000000000000000
0000000000000000004222230000042230010
0000000000000000000000000000000000000
0000000000000000000000000000000000000
0042230000422222300000004222300000000
0000000000000000000000000000000000000
0000000000000000000000000000000000000
